1111111111
1000000001
1000000001
1000111001
1000111001
1000000001
1000000001
1111111111

